1,141,141,141,141,141,141,141,141,141,141,141,141,141,141,277,
231,231,231,141,141,141,141,141,141,141,141,141,141,141,277,141,
141,141,231,141,141,141,141,141,141,141,1049,1050,141,141,141,141,
141,141,231,231,231,232,231,231,141,141,1095,1096,141,141,141,141,
141,141,141,141,141,141,141,231,231,231,141,141,141,141,141,141,
141,141,141,141,141,141,141,141,141,231,141,141,141,141,141,141,
141,141,141,141,141,141,141,141,141,232,231,231,231,231,141,141,
141,141,141,141,141,141,141,141,141,141,141,141,141,231,141,141,