370,94,94,94,94,94,94,94,94,94,94,94,94,94,94,94
370,370,370,370,94,94,94,94,94,94,1047,1048,94,94,94,94
94,94,94,370,94,94,94,94,94,94,1093,1094,94,94,94,94
94,94,94,370,370,370,370,94,94,94,94,94,94,94,94,94
94,94,94,94,94,94,370,370,370,370,370,370,370,94,94,94
94,94,94,94,94,94,94,94,94,94,94,94,370,94,94,94
94,94,94,94,94,94,94,94,94,94,94,94,370,370,370,370
94,94,94,94,94,94,94,94,94,94,94,94,94,94,94,94
